back away	отступать, отказываться	
back off	отступать, отстать	
be back	вернуться, возвращаться	
be off	уходить, уезжать, быть свободным, не работающим	
be out	отсутствовать, не быть на месте	
be over	окончиться, завершиться	
be up	проснуться, бодрствовать, подниматься	
be up to	собираться, намереваться что-то сделать	
blow out	разбиться в дребезги, гаснуть	
blow up	взорваться, выйти из себя, взрывать	
break down	сломаться, потерпеть неудачу	
break in	вмешиваться в разговор, врываться, вламывать	
break into	вламываться, ворваться	
break off	прерваться	
break out	вырваться, вспыхивать, разразиться	
break up	прекращать, расставаться, расходиться	
burst out	воскликнуть, разразиться смехом	
call back	перезвонить, позвать назад	
calm down	успокаиваться	
carry on	продолжать заниматься чем-либо	
catch out	выполнять, осуществлять	
catch up	догнать, настичь, наверстать, нагнать	
check in	зарегестрироваться	
check out	проверять, выяснять, выписаться из	
clean up	чистить, убирать, приводить в порядок	
come across	натолкнуться, случайно встретить	
come along	идти вместе, сопровождать	
come back	возвращаться	
come by	заходить, приходить	
сome down	уменьшаться, снижаться, рассматривать что-то	
come forward	выходить вперед, выдвигаться	
come from	взяться, родом из	
come in	входить, приходить	
come off	отделяться, отрываться, покидать сходить	
come on	давай! пошли! брось! проходить, приходить	
сome out	выходить, приезжать, выступить	
come over	приходить, подходить, заезжать	
come up	подниматься, подходить, появляться	
сount on	рассчитывать на что-либо/кого-либо	
cut off	отрезать, отсекать, прерывать	
cut out	вырезать, прекращать, пресекать	
end up	кончить, закончить, попасть, оказаться	
fall down	падать, упасть, рухнуть	
fall off	падать, отпадать, отваливаться	
figure out	сообразить, выяснить, понять, разобраться	
find&nbsp;out	узнать	
get along	уживаться, ладить, справляться с делами	
get arround	обойти, преодолеть, справиться, перехитрить	
get away	ускользнуть, уходить	
get back	вернуться	
get down	опустить	
get in	войти, забраться в, проникнуть, попасть в	
get off	выходить, покидать, уносить, начинать, отбывать	
get on	садиться на/в, приступить к, продолжить	
get out	уходить, уезжать, выходить, вынимать, вытаскивать	
get over	справиться, понять, добраться до, перейти	
get through	проходить, проникать через, выдержать	
get up	вставать, подниматься, просыпаться	
give up	сдаваться, отказаться, оставить, бросить	
go along	соглашаться, поддерживать, идти вместе	
go around	расхаживать повсюду, обойти вокруг	
go away	уходить, уезжать	
go back	возвращаться	
go by	проходить, проезжать мимо, проходить (о времени)	
go down	спускаться, идти, ехать вниз	
go in	входить	
go off	уходить, уезжать, убегать, улетать	
go on	продолжайте! происходить	
go out	выходить	
go over	подойти, приехать, повторять, перепроверять	
go through	пройти через, сквозь, повторять	
go up	подниматься	
grow up	вырастать, становиться взрослым	
hang around	слоняться, бездельничать, болтаться без дела	
hang on	держаться, вцепиться, ждать у телефона	
hang up	повесить, положить трубку, висеть	
help out	помочь, выручить, вывести из затруднительного положения	
hold on	держаться, вцепиться, ждать у телефона	
hold out	протягивать, вытягивать	
hold up	поднимать, отсрочить, остановить, задержать	
keep on	продолжать	
keep up	не отставать, продолжать, поддерживать	
knock down	сбить с ног, сносить, разрушать, понижать	
knock off	сбавить (цену), быстро сделать	
knock out	оглушить, поразить, выбить	
let in	впускать	
let out	выпускать, освобождать	
lie down	лечь, прилечь	
line up	выстраивать, становиться в линию, в очередь	
look back	оглядываться, оборачиваться	
look down	смотреть, смотреть вниз	
look for	искать, подыскивать, присматривать	
look forward to	ожидать с нетерпением	
look out	выглядывать, быть осторожным	
look over	смотреть, просматривать, осматривать	
make out	понимать, различать, составлять, справляться	
make up	составлять, сочинять, компенсировать	
move in	въезжать, поселяться, входить	
move on	идти дальше, продолжать движение	
move out	съезжать, выдвигаться, выходить	
pass out	терять сознание, раздавать, распределять	
pick up	взять (предмет, человека, след и т.п.)	
point out	указывать, подчеркивать, заметить	
pull away	отъезжать, трогаться, отпрянуть, отстраниться	
pull off	снимать, стаскивать, справиться, выполнить	
pull on	натягивать (одевать), тянуть на себя	
pull out	вытаскивать, вынимать, выйти из дела, выдергивать	
pull up	подъезжать, останавливаться	
put away	убирать, отложить, прятать	
put down	положить, опустить	
put in	вставлять	
put on	надевать, одевать, включать, приводить в действие	
put out	вытягивать, выставлять, тушить	
put up	поднимать, строить, финансировать	
run away	убегать, удирать	
run into	встретить, столкнуться, наскочить	
run off	удирать, убегать, сбегать	
run out	выбегать, кончаться, истощаться	
run over	подбегать, переехать, задавить	
set down	поставить, положить	
set off	отправляться (в путь)	
set up	устраивать, организовывать, создавать	
settle down	усаживаться, поселяться, успокаиваться	
shoot out	выскочить, вылететь	
show up	появляться, приходить	
shut down	закрыть, прикрыть, выключить, отключить	
shut up	заставить замолчать	
sit back	откинуться назад/ на спинку сиденья	
sit down	сдаиться, усаживаться, занимать место	
sit up	приподняться, садиться	
spread out	растягивать, развертывать, расширять	
stand by	приготовиться, ждать, поддерживать	
stand out	выделяться, быть заметным	
stand up	вставать, выпрямляться	
stick out	торчать, выпирать, вытягивать, протягивать	
switch off	выключать	
switch on	включать, соединять абонента	
take away	убирать, забирать, отбирать, отнимать	
take back	отдать назад, взять обратно	
take in	вбирать, воспринимать, впустить, принять	
take off	снимать с себя, уходить уезжать	
take on	приобретать, принимать (форму, вид и т.п.)	
take out	вынимать, вытаскивать	
take over	сменять, перенимать, принимать должность	
take up	обсуждать, занимать (место), заняться чем-либо	
throw up	выкинуть, рвать, вскинуть, поднять	
turn around	оборачиваться	
turn away	отворачиваться	
turn back	возвращаться, поворачиваться назад	
turn down	отвергать, отклонять, убавлять, уменьшать	
turn into	превращаться	
turn off	выключать, сворачивать, поворачивать	
turn out	оказаться, получиться, выйти	
turn over	переворачиваться, передавать	
turn up	появляться, случаться	
wake up	просыпаться, будить кого-либо	
walk around	ходить, бродить повсюду	
walk away	уходить	
walk back	возвращаться, идти назад/обратно	
walk in	входить	
walk off	уходить, избавиться	
walk out	выходить, отказаться участвовать	
walk over	легко победить	
walk up	подойти ближе	
watch out	остерегаться, быть начеку	
wind up	очутиться, оказаться, уладить	
work up	обработать, создать, разрабатывать	
write down	записывать, излагать письменно	